People associated with Agriculture	Agriculture-associated people
People associated with commercial activities	Commercial activity -associated people
People associated with education & communication	Educators & Communicators
People associated with entertainment & sports	Entertainment & Sports -associated people
People associated with health & safety	Health & Safety -associated people
People associated with manual labor	Manual Laborers
People associated with military activities	Military Activity -associated people
People associated with politics & government	Politics & Government -associated people
People associated with religion	Religion-associated people
People associated with transportation	Transportation-associated people
People with disabilities	Disabled people
Clothing and dress	Clothing & dress
Pittsbu	Pittsburgh
Pittsburhgh	Pittsburgh
Pittsubrgh	Pittsburgh
Pittsurgh	Pittsburgh
Pennylvania	Pennsylvania
Pennsyvlania	Pennsylvania
Pennsylvnaia	Pennsylvania
Pennsylvnia	Pennsylvania
Pennslyvania	Pennsylvania
Pennsylvaania	Pennsylvania
Pennsyvlanis	Pennsylvania
Pennslvania	Pennsylvania
Pennsyvania	Pennsylvania
Pennsylva	Pennsylvania
Pennsylvani	Pennsylvania
Penns	Pennsylvania
Pennsylv	Pennsylvania
Pennsylania	Pennsylvania
Pennsylavnia	Pennsylvania
Pennsylvaia	Pennsylvania
Pennsylvania.	Pennsylvania
Pennsyvlvania	Pennsylvania
Pa.)	Pennsylvania
Pennsylva nia	Pennsylvania
