Places -- Borneo	Places -- Asia -- Borneo
Places -- Burma	Places -- Asia -- Burma
Places -- Bahrain	Places -- Asia -- Bahrain
Places -- Bangladesh	Places -- Asia -- Bangladesh
Places -- Azerbaijan	Places -- Asia -- Azerbaijan
Places -- Armenia (Republic)	Places -- Asia -- Armenia (Republic)
Places -- Afghanistan	Places -- Asia -- Afghanistan
Places -- Bhutan	Places -- Asia -- Bhutan
Places -- Brunei	Places -- Asia -- Brunei
Places -- Cambodia	Places -- Asia -- Cambodia
Places -- China	Places -- Asia -- China
Places -- Anhui Sheng (China)	Places -- Asia -- China -- Anhui Sheng (China)
Places -- Zhejiang Sheng (China)	Places -- Asia -- China -- Zhejiang Sheng (China)
Places -- Chongqing (China)	Places -- Asia -- China -- Chongqing (China)
Places -- Fujian Sheng (China)	Places -- Asia -- China -- Fujian Sheng (China)
Places -- Hainan Sheng (China)	Places -- Asia -- China -- Hainan Sheng (China)
Places -- Heilongjiang Sheng (China)	Places -- Asia -- China -- Heilongjiang Sheng (China)
Places -- Hubei Sheng (China)	Places -- Asia -- China -- Hubei Sheng (China)
Places -- Hong Kong (China)	Places -- Asia -- China -- Hong Kong (China)
Places -- Henan Sheng (China)	Places -- Asia -- China -- Henan Sheng (China)
Places -- Hebei Sheng (China)	Places -- Asia -- China -- Hebei Sheng (China)
Places -- Hunan Sheng (China)	Places -- Asia -- China -- Hunan Sheng (China)
Places -- Inner Mongolia (China)	Places -- Asia -- China -- Inner Mongolia (China)
Places -- Gansu Sheng (China)	Places -- Asia -- China -- Gansu Sheng (China)
Places -- Guangxi Zhuangzu Zizhiqu (China)	Places -- Asia -- China -- Guangxi Zhuangzu Zizhiqu (China)
Places -- Jiangxi Sheng (China)	Places -- Asia -- China -- Jiangxi Sheng (China)
Places -- Guangdong Sheng (China)	Places -- Asia -- China -- Guangdong Sheng (China)
Places -- Jilin Sheng (China)	Places -- Asia -- China -- Jilin Sheng (China)
Places -- Jiangsu Sheng (China)	Places -- Asia -- China -- Jiangsu Sheng (China)
Places -- Guizhou Sheng (China)	Places -- Asia -- China -- Guizhou Sheng (China)
Places -- Liaoning Sheng (China)	Places -- Asia -- China -- Liaoning Sheng (China)
Places -- Macao (China : Special Administrative Region)	Places -- Asia -- China -- Macao (China : Special Administrative Region)
Places -- Ningxia Huizu Zizhiqu (China)	Places -- Asia -- China -- Ningxia Huizu Zizhiqu (China)
Places -- Beijing (China)	Places -- Asia -- China -- Beijing (China)
Places -- Shanxi Sheng (China)	Places -- Asia -- China -- Shanxi Sheng (China)
Places -- Shanghai (China)	Places -- Asia -- China -- Shanghai (China)
Places -- Shandong Sheng (China)	Places -- Asia -- China -- Shandong Sheng (China)
Places -- Shaanxi Sheng (China)	Places -- Asia -- China -- Shaanxi Sheng (China)
Places -- Xinjiang Uygur Zizhiqu (China)	Places -- Asia -- China -- Xinjiang Uygur Zizhiqu (China)
Places -- Sichuan Sheng (China)	Places -- Asia -- China -- Sichuan Sheng (China)
Places -- Tibet (China)	Places -- Asia -- China -- Tibet (China)
Places -- Tianjin (China)	Places -- Asia -- China -- Tianjin (China)
Places -- Qinghai Sheng (China)	Places -- Asia -- China -- Qinghai Sheng (China)
Places -- Yunnan Sheng (China)	Places -- Asia -- China -- Yunnan Sheng (China)
Places -- Yangtze River (China)	Places -- Asia -- Yangtze River (China)
Places -- Kunlun Mountains (China and India)	Places -- Asia -- Kunlun Mountains (China and India)
Places -- Bo Hai (China)	Places -- Asia -- Bo Hai (China)
Places -- Xi River (China)	Places -- Asia -- Xi River (China)
Places -- Yellow River (China)	Places -- Asia -- Yellow River (China)
Places -- Sri Lanka	Places -- Asia -- Sri Lanka
Places -- Taiwan	Places -- Asia -- Taiwan
Places -- Cyprus	Places -- Asia -- Cyprus
Places -- East Timor	Places -- Asia -- East Timor
Places -- Georgia (Republic)	Places -- Asia -- Georgia (Republic)
Places -- Hong Kong	Places -- Asia -- Hong Kong
Places -- India	Places -- Asia -- India
Places -- Indonesia	Places -- Asia -- Indonesia
Places -- Iraq	Places -- Asia -- Iraq
Places -- Iran	Places -- Asia -- Iran
Places -- Israel	Places -- Asia -- Israel
Places -- Japan	Places -- Asia -- Japan
Places -- Jordan	Places -- Asia -- Jordan
Places -- Kyrgyzstan	Places -- Asia -- Kyrgyzstan
Places -- Korea (North)	Places -- Asia -- Korea (North)
Places -- Korea (South)	Places -- Asia -- Korea (South)
Places -- Korea	Places -- Asia -- Korea
Places -- Kuwait	Places -- Asia -- Kuwait
Places -- Kazakhstan	Places -- Asia -- Kazakhstan
Places -- Lebanon	Places -- Asia -- Lebanon
Places -- Laos	Places -- Asia -- Laos
Places -- Macao	Places -- Asia -- Macao
Places -- Oman	Places -- Asia -- Oman
Places -- Mongolia	Places -- Asia -- Mongolia
Places -- Malaysia	Places -- Asia -- Malaysia
Places -- Nepal	Places -- Asia -- Nepal
Places -- New Guinea	Places -- Asia -- New Guinea
Places -- Okinawa	Places -- Asia -- Okinawa
Places -- Philippines	Places -- Asia -- Philippines
Places -- Pakistan	Places -- Asia -- Pakistan
Places -- Papua New Guinea	Places -- Asia -- Papua New Guinea
Places -- Portuguese Timor	Places -- Asia -- Portuguese Timor
Places -- Qatar	Places -- Asia -- Qatar
Places -- Singapore	Places -- Asia -- Singapore
Places -- Sikkim	Places -- Asia -- Sikkim
Places -- Saudi Arabia	Places -- Asia -- Saudi Arabia
Places -- Syria	Places -- Asia -- Syria
Places -- Tajikistan	Places -- Asia -- Tajikistan
Places -- Thailand	Places -- Asia -- Thailand
Places -- Turkmenistan	Places -- Asia -- Turkmenistan
Places -- United Arab Emirates	Places -- Asia -- United Arab Emirates
Places -- Turkey	Places -- Asia -- Turkey
Places -- Uzbekistan	Places -- Asia -- Uzbekistan
Places -- Viet Nam	 North	Places -- Asia -- Viet Nam	 North
Places -- Viet Nam	 South	Places -- Asia -- Viet Nam	 South
Places -- Vietnam	Places -- Asia -- Vietnam
Places -- Yemen (Republic)	Places -- Asia -- Yemen (Republic)
Places -- Yemen (People's Democratic Republic)	Places -- Asia -- Yemen (People's Democratic Republic)
Places -- Amur River (China and Russia)	Places -- Asia -- Amur River (China and Russia)
Places -- Bengal	 Bay of	Places -- Asia -- Bengal	 Bay of
Places -- Asia	 Central	Places -- Asia -- Asia	 Central
Places -- East Asia	Places -- Asia -- East Asia
Places -- Thailand	 Gulf of	Places -- Asia -- Thailand	 Gulf of
Places -- Mekong River	Places -- Asia -- Mekong River
Places -- Himalaya Mountains	Places -- Asia -- Himalaya Mountains
Places -- Indochina	Places -- Asia -- Indochina
Places -- Caspian Sea	Places -- Asia -- Caspian Sea
Places -- Malaya	Places -- Asia -- Malaya
Places -- East China Sea	Places -- Asia -- East China Sea
Places -- South China Sea	Places -- Asia -- South China Sea
Places -- Paracel Islands	Places -- Asia -- Paracel Islands
Places -- Spratly Islands	Places -- Asia -- Spratly Islands
Places -- Persian Gulf	Places -- Asia -- Persian Gulf
Places -- Arabian Peninsula	Places -- Asia -- Arabian Peninsula
Places -- Southeast Asia	Places -- Asia -- Southeast Asia
Places -- Tien Shan	Places -- Asia -- Tien Shan
Places -- Arabian Sea	Places -- Asia -- Arabian Sea
Places -- Middle East	Places -- Asia -- Middle East
Places -- West Bank	Places -- Asia -- Middle East -- West Bank
Places -- Gaza Strip	Places -- Asia -- Middle East -- Gaza Strip
Places -- Israel-Syria Demilitarized Zones	Places -- Asia -- Middle East -- Israel-Syria Demilitarized Zones
Places -- Israel-Jordan Demilitarized Zones	Places -- Asia -- Middle East -- Israel-Jordan Demilitarized Zones
Places -- Iraq-Saudi Arabia Neutral Zone	Places -- Asia -- Middle East -- Iraq-Saudi Arabia Neutral Zone
Places -- Yellow Sea	Places -- Asia -- Yellow Sea
Places -- South Asia	Places -- Asia -- South Asia
Places -- Albania	Places -- Europe -- Albania
Places -- Andorra	Places -- Europe -- Andorra
Places -- Austria	Places -- Europe -- Austria
Places -- Belgium	Places -- Europe -- Belgium
Places -- Bosnia and Hercegovina	Places -- Europe -- Bosnia and Hercegovina
Places -- Bulgaria	Places -- Europe -- Bulgaria
Places -- Belarus	Places -- Europe -- Belarus
Places -- Croatia	Places -- Europe -- Croatia
Places -- Czechoslovakia	Places -- Europe -- Czechoslovakia
Places -- Denmark	Places -- Europe -- Denmark
Places -- Estonia	Places -- Europe -- Estonia
Places -- Finland	Places -- Europe -- Finland
Places -- France	Places -- Europe -- France
Places -- Germany (East)	Places -- Europe -- Germany (East)
Places -- Gibraltar	Places -- Europe -- Gibraltar
Places -- Greece	Places -- Europe -- Greece
Places -- Germany (West)	Places -- Europe -- Germany (West)
Places -- Germany	Places -- Europe -- Germany
Places -- Hungary	Places -- Europe -- Hungary
Places -- Iceland	Places -- Europe -- Iceland
Places -- Ireland	Places -- Europe -- Ireland
Places -- Italy	Places -- Europe -- Italy
Places -- Liechtenstein	Places -- Europe -- Liechtenstein
Places -- Lithuania	Places -- Europe -- Lithuania
Places -- Luxembourg	Places -- Europe -- Luxembourg
Places -- Latvia	Places -- Europe -- Latvia
Places -- Monaco	Places -- Europe -- Monaco
Places -- Malta	Places -- Europe -- Malta
Places -- Moldova	Places -- Europe -- Moldova
Places -- Netherlands	Places -- Europe -- Netherlands
Places -- Norway	Places -- Europe -- Norway
Places -- Poland	Places -- Europe -- Poland
Places -- Portugal	Places -- Europe -- Portugal
Places -- Romania	Places -- Europe -- Romania
Places -- Russia (Federation)	Places -- Europe -- Russia (Federation)
Places -- San Marino	Places -- Europe -- San Marino
Places -- Spain	Places -- Europe -- Spain
Places -- Sweden	Places -- Europe -- Sweden
Places -- Switzerland	Places -- Europe -- Switzerland
Places -- Great Britain	Places -- Europe -- Great Britain
Places -- England	Places -- Europe -- Great Britain -- England
Places -- Northern Ireland	Places -- Europe -- Great Britain -- Northern Ireland
Places -- Scotland	Places -- Europe -- Great Britain -- Scotland
Places -- Great Britain Miscellaneous Island Dependencies	Places -- Europe -- Great Britain -- Great Britain Miscellaneous Island Dependencies
Places -- Wales	Places -- Europe -- Great Britain -- Wales
Places -- Ukraine	Places -- Europe -- Ukraine
Places -- Russia	Places -- Europe -- Russia
Places -- Armenia (Republic)	Places -- Europe -- Russia -- Armenia (Republic)
Places -- Azerbaijan 	Places -- Europe -- Russia -- Azerbaijan 
Places -- Belarus	Places -- Europe -- Russia -- Belarus
Places -- Estonia	Places -- Europe -- Russia -- Estonia
Places -- Georgia (Republic)	Places -- Europe -- Russia -- Georgia (Republic)
Places -- Kyrgyzstan	Places -- Europe -- Russia -- Kyrgyzstan
Places -- Kazakhstan	Places -- Europe -- Russia -- Kazakhstan
Places -- Lithuania	Places -- Europe -- Russia -- Lithuania
Places -- Latvia	Places -- Europe -- Russia -- Latvia
Places -- Moldova	Places -- Europe -- Russia -- Moldova
Places -- Russia (Federation)	Places -- Europe -- Russia -- Russia (Federation)
Places -- Tajikistan	Places -- Europe -- Russia -- Tajikistan
Places -- Turkmenistan	Places -- Europe -- Russia -- Turkmenistan
Places -- Ukraine	Places -- Europe -- Russia -- Ukraine
Places -- Uzbekistan	Places -- Europe -- Russia -- Uzbekistan
Places -- Central Chernozem Region (Russia)	Places -- Europe -- Central Chernozem Region (Russia)
Places -- Siberia	 Eastern (Russia)	Places -- Europe -- Siberia	 Eastern (Russia)
Places -- Russian Far East (Russia)	Places -- Europe -- Russian Far East (Russia)
Places -- Caucasus	Places -- Europe -- Caucasus
Places -- Central Region	 RSFSR	Places -- Europe -- Central Region	 RSFSR
Places -- Soviet Union	 Northwestern	Places -- Europe -- Soviet Union	 Northwestern
Places -- Soviet Central Asia	Places -- Europe -- Soviet Central Asia
Places -- Volga River (Russia)	Places -- Europe -- Volga River (Russia)
Places -- Caucasus	 Northern (Russia)	Places -- Europe -- Caucasus	 Northern (Russia)
Places -- Siberia (Russia)	Places -- Europe -- Siberia (Russia)
Places -- Ural Mountains (Russia)	Places -- Europe -- Ural Mountains (Russia)
Places -- Volgo-Viatskii Region	 RSFSR	Places -- Europe -- Volgo-Viatskii Region	 RSFSR
Places -- Siberia	 Western (Russia)	Places -- Europe -- Siberia	 Western (Russia)
Places -- Vatican City	Places -- Europe -- Vatican City
Places -- Macedonia (Republic)	Places -- Europe -- Macedonia (Republic)
Places -- Slovakia	Places -- Europe -- Slovakia
Places -- Czech Republic	Places -- Europe -- Czech Republic
Places -- Slovenia	Places -- Europe -- Slovenia
Places -- Serbia and Montenegro; Yugoslavia	Places -- Europe -- Serbia and Montenegro; Yugoslavia
Places -- Alps	Places -- Europe -- Alps
Places -- Baltic States	Places -- Europe -- Baltic States
Places -- Europe	 Central	Places -- Europe -- Europe	 Central
Places -- Balkan Peninsula	Places -- Europe -- Balkan Peninsula
Places -- Europe	 Eastern	Places -- Europe -- Europe	 Eastern
Places -- Iberian Peninsula	Places -- Europe -- Iberian Peninsula
Places -- Benelux countries	Places -- Europe -- Benelux countries
Places -- Europe	 Northern	Places -- Europe -- Europe	 Northern
Places -- Danube River	Places -- Europe -- Danube River
Places -- Pyrenees 	Places -- Europe -- Pyrenees 
Places -- Rhine River	Places -- Europe -- Rhine River
Places -- Europe	 Southern	Places -- Europe -- Europe	 Southern
Places -- Europe	 East Central	Places -- Europe -- Europe	 East Central
Places -- Scandinavia	Places -- Europe -- Scandinavia
Places -- Europe	 Western	Places -- Europe -- Europe	 Western
Places -- Algeria	Places -- Africa -- Algeria
Places -- Angola	Places -- Africa -- Angola
Places -- Burundi	Places -- Africa -- Burundi
Places -- Botswana	Places -- Africa -- Botswana
Places -- Biafra	Places -- Africa -- Biafra
Places -- Chad	Places -- Africa -- Chad
Places -- Congo (Brazzaville)	Places -- Africa -- Congo (Brazzaville)
Places -- Congo (Democratic Republic)	Places -- Africa -- Congo (Democratic Republic)
Places -- Cameroon	Places -- Africa -- Cameroon
Places -- Central African Republic	Places -- Africa -- Central African Republic
Places -- Benin	Places -- Africa -- Benin
Places -- Eritrea	Places -- Africa -- Eritrea
Places -- Equatorial Guinea	Places -- Africa -- Equatorial Guinea
Places -- Ethiopia	Places -- Africa -- Ethiopia
Places -- Djibouti	Places -- Africa -- Djibouti
Places -- Ghana	Places -- Africa -- Ghana
Places -- Gambia	Places -- Africa -- Gambia
Places -- Gabon	Places -- Africa -- Gabon
Places -- Guinea	Places -- Africa -- Guinea
Places -- Ifni	Places -- Africa -- Ifni
Places -- Côte d'Ivoire	Places -- Africa -- Côte d'Ivoire
Places -- Kenya	Places -- Africa -- Kenya
Places -- Liberia	Places -- Africa -- Liberia
Places -- Lesotho	Places -- Africa -- Lesotho
Places -- Libya	Places -- Africa -- Libya
Places -- Madagascar	Places -- Africa -- Madagascar
Places -- Mali	Places -- Africa -- Mali
Places -- Morocco	Places -- Africa -- Morocco
Places -- Mauritania	Places -- Africa -- Mauritania
Places -- Malawi	Places -- Africa -- Malawi
Places -- Mozambique	Places -- Africa -- Mozambique
Places -- Niger	Places -- Africa -- Niger
Places -- Nigeria	Places -- Africa -- Nigeria
Places -- Guinea-Bissau	Places -- Africa -- Guinea-Bissau
Places -- Zimbabwe	Places -- Africa -- Zimbabwe
Places -- Rwanda	Places -- Africa -- Rwanda
Places -- South Africa	Places -- Africa -- South Africa
Places -- Sao Tome and Principe	Places -- Africa -- Sao Tome and Principe
Places -- Senegal	Places -- Africa -- Senegal
Places -- Spanish North Africa	Places -- Africa -- Spanish North Africa
Places -- Sudan	Places -- Africa -- Sudan
Places -- Sierra Leone	Places -- Africa -- Sierra Leone
Places -- Somalia	Places -- Africa -- Somalia
Places -- Swaziland	Places -- Africa -- Swaziland
Places -- Western Sahara	Places -- Africa -- Western Sahara
Places -- Namibia	Places -- Africa -- Namibia
Places -- Togo	Places -- Africa -- Togo
Places -- Tunisia	Places -- Africa -- Tunisia
Places -- Tanzania	Places -- Africa -- Tanzania
Places -- Egypt	Places -- Africa -- Egypt
Places -- Uganda	Places -- Africa -- Uganda
Places -- Burkina Faso	Places -- Africa -- Burkina Faso
Places -- Zambia	Places -- Africa -- Zambia
Places -- Atlas Mountains	Places -- Africa -- Atlas Mountains
Places -- Africa	 Sub-Saharan	Places -- Africa -- Africa	 Sub-Saharan
Places -- Africa	 Central	Places -- Africa -- Africa	 Central
Places -- Sahara	Places -- Africa -- Sahara
Places -- Africa	 Eastern	Places -- Africa -- Africa	 Eastern
Places -- Africa	 North	Places -- Africa -- Africa	 North
Places -- Congo River	Places -- Africa -- Congo River
Places -- Africa	 Northeast	Places -- Africa -- Africa	 Northeast
Places -- Niger River	Places -- Africa -- Niger River
Places -- Nile River	Places -- Africa -- Nile River
Places -- Sudan (Region)	Places -- Africa -- Sudan (Region)
Places -- Africa	 French-speaking Equatorial	Places -- Africa -- Africa	 French-speaking Equatorial
Places -- Great Rift Valley	Places -- Africa -- Great Rift Valley
Places -- Africa	 Southern	Places -- Africa -- Africa	 Southern
Places -- Suez Canal (Egypt)	Places -- Africa -- Suez Canal (Egypt)
Places -- Volta River (Ghana)	Places -- Africa -- Volta River (Ghana)
Places -- Africa	 West	Places -- Africa -- Africa	 West
Places -- Zambezi River	Places -- Africa -- Zambezi River
Places -- British Indian Ocean Territory	Places -- Indian Ocean -- British Indian Ocean Territory
Places -- Comoros	Places -- Indian Ocean -- Comoros
Places -- Terres australes et antarctiques françaises	Places -- Indian Ocean -- Terres australes et antarctiques françaises
Places -- Heard and McDonald Islands	Places -- Indian Ocean -- Heard and McDonald Islands
Places -- Mauritius	Places -- Indian Ocean -- Mauritius
Places -- Mayotte	Places -- Indian Ocean -- Mayotte
Places -- Réunion	Places -- Indian Ocean -- Réunion
Places -- Seychelles	Places -- Indian Ocean -- Seychelles
Places -- Christmas Island (Indian Ocean)	Places -- Indian Ocean -- Christmas Island (Indian Ocean)
Places -- Cocos (Keeling) Islands	Places -- Indian Ocean -- Cocos (Keeling) Islands
Places -- Maldives	Places -- Indian Ocean -- Maldives
Places -- Socotra Island	Places -- Indian Ocean -- Socotra Island
Places -- North Atlantic Ocean	Places -- Atlantic Ocean -- North Atlantic Ocean
Places -- Azores	Places -- Atlantic Ocean -- Azores
Places -- Bermuda Islands	Places -- Atlantic Ocean -- Bermuda Islands
Places -- Canary Islands	Places -- Atlantic Ocean -- Canary Islands
Places -- Cape Verde	Places -- Atlantic Ocean -- Cape Verde
Places -- Faroe Islands	Places -- Atlantic Ocean -- Faroe Islands
Places -- Jan Mayen Island	Places -- Atlantic Ocean -- Jan Mayen Island
Places -- Madeira Islands	Places -- Atlantic Ocean -- Madeira Islands
Places -- Svalbard (Norway)	Places -- Atlantic Ocean -- Svalbard (Norway)
Places -- South Atlantic Ocean	Places -- Atlantic Ocean -- South Atlantic Ocean
Places -- Ascension Island (Atlantic Ocean)	Places -- Atlantic Ocean -- Ascension Island (Atlantic Ocean)
Places -- Bouvet Island	Places -- Atlantic Ocean -- Bouvet Island
Places -- Falkland Islands	Places -- Atlantic Ocean -- Falkland Islands
Places -- Tristan da Cunha	Places -- Atlantic Ocean -- Tristan da Cunha
Places -- Saint Helena	Places -- Atlantic Ocean -- Saint Helena
Places -- South Georgia and South Sandwich Islands	Places -- Atlantic Ocean -- South Georgia and South Sandwich Islands
Places -- Canada	Places -- North America -- Canada
Places -- Alberta	Places -- North America -- Canada -- Alberta
Places -- British Columbia	Places -- North America -- Canada -- British Columbia
Places -- Manitoba	Places -- North America -- Canada -- Manitoba
Places -- Newfoundland and Labrador	Places -- North America -- Canada -- Newfoundland and Labrador
Places -- New Brunswick	Places -- North America -- Canada -- New Brunswick
Places -- Nova Scotia	Places -- North America -- Canada -- Nova Scotia
Places -- Northwest Territories	Places -- North America -- Canada -- Northwest Territories
Places -- Nunavut	Places -- North America -- Canada -- Nunavut
Places -- Ontario	Places -- North America -- Canada -- Ontario
Places -- Prince Edward Island	Places -- North America -- Canada -- Prince Edward Island
Places -- Québec (Province)	Places -- North America -- Canada -- Québec (Province)
Places -- Saskatchewan	Places -- North America -- Canada -- Saskatchewan
Places -- Yukon Territory	Places -- North America -- Canada -- Yukon Territory
Places -- Hudson Bay	Places -- North America -- Hudson Bay
Places -- Maritime Provinces	Places -- North America -- Maritime Provinces
Places -- Prairie Provinces	Places -- North America -- Prairie Provinces
Places -- Greenland	Places -- North America -- Greenland
Places -- Mexico	Places -- North America -- Mexico
Places -- United States	Places -- North America -- United States
Places -- Alaska	Places -- North America -- United States -- Alaska
Places -- Alabama	Places -- North America -- United States -- Alabama
Places -- Arkansas	Places -- North America -- United States -- Arkansas
Places -- Arizona	Places -- North America -- United States -- Arizona
Places -- California	Places -- North America -- United States -- California
Places -- Colorado	Places -- North America -- United States -- Colorado
Places -- Connecticut	Places -- North America -- United States -- Connecticut
Places -- Washington (D.C.)	Places -- North America -- United States -- Washington (D.C.)
Places -- Delaware	Places -- North America -- United States -- Delaware
Places -- Florida	Places -- North America -- United States -- Florida
Places -- Georgia	Places -- North America -- United States -- Georgia
Places -- Hawaii	Places -- North America -- United States -- Hawaii
Places -- Iowa	Places -- North America -- United States -- Iowa
Places -- Idaho	Places -- North America -- United States -- Idaho
Places -- Illinois	Places -- North America -- United States -- Illinois
Places -- Indiana	Places -- North America -- United States -- Indiana
Places -- Kansas	Places -- North America -- United States -- Kansas
Places -- Kentucky	Places -- North America -- United States -- Kentucky
Places -- Louisiana	Places -- North America -- United States -- Louisiana
Places -- Massachusetts	Places -- North America -- United States -- Massachusetts
Places -- Maryland	Places -- North America -- United States -- Maryland
Places -- Maine	Places -- North America -- United States -- Maine
Places -- Michigan	Places -- North America -- United States -- Michigan
Places -- Minnesota	Places -- North America -- United States -- Minnesota
Places -- Missouri	Places -- North America -- United States -- Missouri
Places -- Mississippi	Places -- North America -- United States -- Mississippi
Places -- Montana	Places -- North America -- United States -- Montana
Places -- Nebraska	Places -- North America -- United States -- Nebraska
Places -- North Carolina	Places -- North America -- United States -- North Carolina
Places -- North Dakota	Places -- North America -- United States -- North Dakota
Places -- New Hampshire	Places -- North America -- United States -- New Hampshire
Places -- New Jersey	Places -- North America -- United States -- New Jersey
Places -- New Mexico	Places -- North America -- United States -- New Mexico
Places -- Nevada	Places -- North America -- United States -- Nevada
Places -- New York	Places -- North America -- United States -- New York
Places -- Ohio	Places -- North America -- United States -- Ohio
Places -- Oklahoma	Places -- North America -- United States -- Oklahoma
Places -- Oregon	Places -- North America -- United States -- Oregon
Places -- Pennsylvania	Places -- North America -- United States -- Pennsylvania
Places -- Rhode Island	Places -- North America -- United States -- Rhode Island
Places -- South Carolina	Places -- North America -- United States -- South Carolina
Places -- South Dakota	Places -- North America -- United States -- South Dakota
Places -- Tennessee	Places -- North America -- United States -- Tennessee
Places -- Texas	Places -- North America -- United States -- Texas
Places -- Utah	Places -- North America -- United States -- Utah
Places -- Virginia	Places -- North America -- United States -- Virginia
Places -- Vermont	Places -- North America -- United States -- Vermont
Places -- Washington (State)	Places -- North America -- United States -- Washington (State)
Places -- Wisconsin	Places -- North America -- United States -- Wisconsin
Places -- West Virginia	Places -- North America -- United States -- West Virginia
Places -- Wyoming	Places -- North America -- United States -- Wyoming
Places -- Appalachian Mountains	Places -- North America -- Appalachian Mountains
Places -- Middle West	Places -- North America -- Middle West
Places -- Northeastern States	Places -- North America -- Northeastern States
Places -- Middle Atlantic States	Places -- North America -- Middle Atlantic States
Places -- Mississippi River	Places -- North America -- Mississippi River
Places -- New England	Places -- North America -- New England
Places -- Ohio River	Places -- North America -- Ohio River
Places -- West (U.S.)	Places -- North America -- West (U.S.)
Places -- East (U.S.)	Places -- North America -- East (U.S.)
Places -- Missouri River	Places -- North America -- Missouri River
Places -- Southwest	 New	Places -- North America -- Southwest	 New
Places -- Southern States	Places -- North America -- Southern States
Places -- Northwest (U.S.)	Places -- North America -- Northwest (U.S.)
Places -- Saint Pierre and Miquelon	Places -- North America -- Saint Pierre and Miquelon
Places -- Belize	Places -- Central America -- Belize
Places -- Costa Rica	Places -- Central America -- Costa Rica
Places -- Canal Zone	Places -- Central America -- Canal Zone
Places -- El Salvador	Places -- Central America -- El Salvador
Places -- Guatemala	Places -- Central America -- Guatemala
Places -- Honduras	Places -- Central America -- Honduras
Places -- Nicaragua	Places -- Central America -- Nicaragua
Places -- Panama	Places -- Central America -- Panama
Places -- Antigua and Barbuda	Places -- West Indies -- Antigua and Barbuda
Places -- Aruba	Places -- West Indies -- Aruba
Places -- Barbados	Places -- West Indies -- Barbados
Places -- Barbuda	Places -- West Indies -- Barbuda
Places -- Bahamas	Places -- West Indies -- Bahamas
Places -- Bonaire (Netherlands Antilles)	Places -- West Indies -- Bonaire (Netherlands Antilles)
Places -- Cayman Islands	Places -- West Indies -- Cayman Islands
Places -- Curaçao (Netherlands Antilles)	Places -- West Indies -- Curaçao (Netherlands Antilles)
Places -- Cuba	Places -- West Indies -- Cuba
Places -- Dominica	Places -- West Indies -- Dominica
Places -- Dominican Republic	Places -- West Indies -- Dominican Republic
Places -- Sint Eustatius (Netherlands Antilles)	Places -- West Indies -- Sint Eustatius (Netherlands Antilles)
Places -- Greater Antilles	Places -- West Indies -- Greater Antilles
Places -- Grenada	Places -- West Indies -- Grenada
Places -- Guadeloupe	Places -- West Indies -- Guadeloupe
Places -- Grenadines	Places -- West Indies -- Grenadines
Places -- Hispaniola	Places -- West Indies -- Hispaniola
Places -- Haiti	Places -- West Indies -- Haiti
Places -- Jamaica	Places -- West Indies -- Jamaica
Places -- Antilles	 Lesser	Places -- West Indies -- Antilles	 Lesser
Places -- Leeward Islands (West Indies)	Places -- West Indies -- Leeward Islands (West Indies)
Places -- Montserrat	Places -- West Indies -- Montserrat
Places -- Martinique	Places -- West Indies -- Martinique
Places -- Netherlands Antilles	Places -- West Indies -- Netherlands Antilles
Places -- Puerto Rico	Places -- West Indies -- Puerto Rico
Places -- Saint-Barthélemy	Places -- West Indies -- Saint-Barthélemy
Places -- Saba (Netherlands Antilles)	Places -- West Indies -- Saba (Netherlands Antilles)
Places -- Saint Martin (West Indies)	Places -- West Indies -- Saint Martin (West Indies)
Places -- Swan Islands (Honduras)	Places -- West Indies -- Swan Islands (Honduras)
Places -- Turks and Caicos Islands	Places -- West Indies -- Turks and Caicos Islands
Places -- Trinidad and Tobago	Places -- West Indies -- Trinidad and Tobago
Places -- United States Miscellaneous Caribbean Islands	Places -- West Indies -- United States Miscellaneous Caribbean Islands
Places -- British Virgin Islands	Places -- West Indies -- British Virgin Islands
Places -- Virgin Islands of the United States	Places -- West Indies -- Virgin Islands of the United States
Places -- Virgin Islands	Places -- West Indies -- Virgin Islands
Places -- Windward Islands (West Indies)	Places -- West Indies -- Windward Islands (West Indies)
Places -- Anguilla	Places -- West Indies -- Anguilla
Places -- Saint Kitts and Nevis	Places -- West Indies -- Saint Kitts and Nevis
Places -- Saint Lucia	Places -- West Indies -- Saint Lucia
Places -- Saint Vincent and the Grenadines	Places -- West Indies -- Saint Vincent and the Grenadines
Places -- American Samoa	Places -- Oceania -- American Samoa
Places -- Caroline Islands	Places -- Oceania -- Caroline Islands
Places -- Canton and Enderbury Islands	Places -- Oceania -- Canton and Enderbury Islands
Places -- Cook Islands	Places -- Oceania -- Cook Islands
Places -- Easter Island	Places -- Oceania -- Easter Island
Places -- Fiji	Places -- Oceania -- Fiji
Places -- French Polynesia	Places -- Oceania -- French Polynesia
Places -- Galapagos Islands	Places -- Oceania -- Galapagos Islands
Places -- Gilbert and Ellice Islands	Places -- Oceania -- Gilbert and Ellice Islands
Places -- Guam	Places -- Oceania -- Guam
Places -- Johnston Island 	Places -- Oceania -- Johnston Island 
Places -- Kiribati	Places -- Oceania -- Kiribati
Places -- Kermadec Islands	Places -- Oceania -- Kermadec Islands
Places -- Line Islands	Places -- Oceania -- Line Islands
Places -- Melanesia	Places -- Oceania -- Melanesia
Places -- Micronesia (Federated States)	Places -- Oceania -- Micronesia (Federated States)
Places -- New Caledonia	Places -- Oceania -- New Caledonia
Places -- Vanuatu	Places -- Oceania -- Vanuatu
Places -- Nauru	Places -- Oceania -- Nauru
Places -- Pitcairn Island	Places -- Oceania -- Pitcairn Island
Places -- Palau	Places -- Oceania -- Palau
Places -- Polynesia	Places -- Oceania -- Polynesia
Places -- Ryukyu Islands	 Southern	Places -- Oceania -- Ryukyu Islands	 Southern
Places -- Santa Cruz Islands	Places -- Oceania -- Santa Cruz Islands
Places -- Samoan Islands	Places -- Oceania -- Samoan Islands
Places -- Solomon Islands	Places -- Oceania -- Solomon Islands
Places -- Tokelau 	Places -- Oceania -- Tokelau 
Places -- Tonga	Places -- Oceania -- Tonga
Places -- Micronesia	Places -- Oceania -- Micronesia
Places -- Tuvalu	Places -- Oceania -- Tuvalu
Places -- United States Miscellaneous Pacific Islands	Places -- Oceania -- United States Miscellaneous Pacific Islands
Places -- Wallis and Futuna Islands	Places -- Oceania -- Wallis and Futuna Islands
Places -- Wake Island	Places -- Oceania -- Wake Island
Places -- Samoa	Places -- Oceania -- Samoa
Places -- Mariana Islands	Places -- Oceania -- Mariana Islands
Places -- Marshall Islands	Places -- Oceania -- Marshall Islands
Places -- Midway Islands	Places -- Oceania -- Midway Islands
Places -- Niue	Places -- Oceania -- Niue
Places -- Argentina	Places -- South America -- Argentina
Places -- Brazil	Places -- South America -- Brazil
Places -- Bolivia	Places -- South America -- Bolivia
Places -- Colombia	Places -- South America -- Colombia
Places -- Chile	Places -- South America -- Chile
Places -- Ecuador	Places -- South America -- Ecuador
Places -- French Guiana	Places -- South America -- French Guiana
Places -- Guyana	Places -- South America -- Guyana
Places -- Peru	Places -- South America -- Peru
Places -- Paraguay	Places -- South America -- Paraguay
Places -- Suriname	Places -- South America -- Suriname
Places -- Uruguay	Places -- South America -- Uruguay
Places -- Venezuela	Places -- South America -- Venezuela
Places -- Antarctica	Places -- Antarctic Ocean; Antarctica -- Antarctica
Places -- Ashmore and Cartier Islands	Places -- Australasia -- Ashmore and Cartier Islands
Places -- Australia	Places -- Australasia -- Australia
Places -- Australian Capital Territory	Places -- Australasia -- Australia -- Australian Capital Territory
Places -- Central Australia	Places -- Australasia -- Central Australia
Places -- Eastern Australia	Places -- Australasia -- Eastern Australia
Places -- Northern Australia	Places -- Australasia -- Northern Australia
Places -- New South Wales	Places -- Australasia -- Australia -- New South Wales
Places -- Northern Territory	Places -- Australasia -- Australia -- Northern Territory
Places -- Queensland	Places -- Australasia -- Australia -- Queensland
Places -- South Australia	Places -- Australasia -- Australia -- South Australia
Places -- Tasmania	Places -- Australasia -- Australia -- Tasmania
Places -- Victoria	Places -- Australasia -- Australia -- Victoria
Places -- Western Australia	Places -- Australasia -- Australia -- Western Australia
Places -- Coral Sea Islands	Places -- Australasia -- Coral Sea Islands
Places -- New Zealand	Places -- Australasia -- New Zealand
